1111111111
1P000100C1
11110001C1
1E00010111
111C110C11
1111111111