1111111111111111
1P00000000000000
1EC0000000000000
1111111111111111