SO ./textures/s_wall.xpm
NO ./textures/n_wall.xpm
EA ./textures/e_wall.xpm
WE ./textures/w_wall.xpm

F 120,164,75
C 91,144,254

        111111111111111111111111
        1000000000000000000000001
        1110000000000100000000011
        1110000000000100000000011
        1110000000000111110000011
        1110000000000000000000011
        1110000000000001000000011
        1110000000011110100000011
        1110000000000000000000011
        1110000000000000000000011
        1110000000000110000000011
        1110000000000000000000011
        1110000000011100000000011
        1110000000000100000000011
        1110000000000100000000011
        1110000000000100000000011
        1110000N00000100000000011
        1110000000000000000000011
111111111111001111111111111111111
10000001111110000001
10111001000001110101
10000101011110000001
10110101000001110101
10000001011111100001
10111111000000011101
10000001111110000001
11111111111111111111